11111111111111111
1000C00000C000001
10000000000000001
1000P000000E00001
11111111111111111