111111111
1C0000001
1P0000001
100000001
100000011
111111111
