111111111
1CE000001
1P0000001
1P0000001
1P0000001
111111111
